1111111111111111111111111111111111111111111111111111
1P0000000000000000000000000000000000C000000000000001
1111101111111111101111111111111111111111101111111111
1000001000000000000000000000000000000000100000000001
1011111111111111110111111111111111111101111111111111
1000000000000000000100000000000000000000000000000001
1111110111111111111101111111111111111111111111101111
100000010000000000000000000000C000000000000010000N01
1011111110111111111111110111111111111101111111101111
1000000000100000000000000000000000000000000000000001
1111111111111101111111101111111111101111111111111111
1000000000000000100000000000000000000100000000000001
1011111111111111111111111111111111111111101111111111
10000000000000000N0000000000000000000000000000000001
1111101111111111101111111111111111111111101111111111
1000001000000000000000000000000000000000100000000001
1011111111111111110111111111111111111101111111111111
100000000000000000010000000000000000C000000000000001
10000000000000000000000000000000000000000N00000E0001
1111111111111111111111111111111111111111111111111111