111111111111111111111111111111111111111111111111111111111111
1P0000N0000000000000N000000000000000C00000000000000000000001
111110111111111110111111111111111111111110111111111111110001
100000100000000000000000000000000000000010000000000000010001
101111111111111111011111111111111111110111111111111110111101
100000000000000000010000000000000000000000000000000000000001
111111011111111111110111111111111111111111111110111111111101
100000010000000000000000000000C00000000000001000N00000000001
101111111011111111111111011111111111110111111110111111111101
1000000000100000000000N00000000000000N0000000000000000000001
111111111111110111111110111111111110111111111111111110111101
100000000000000010000000000000000000010000000000000N00000001
101111111111111111111111111111111111111110111111111111110101
1000000000000N00000000000000000000000000N0000000000000000001
111110111111111110111111111111111111111110111111111111111101
10000010000000000000N000000000000000000010000000000000000C01
101111111111111111011111111111111111110111111111111110111101
100000000000000000010000000000000000C00000000000000000000001
111111011111111111110111111111111111111111111110111111111101
10000001000000000000000N00000NC00000000000000010000000000N01
101111111011111111111111011111111111110111111110111111111101
10000000001000000000000000NC00000000000000000000000000000001
111111111111110111111110111111111110111111111111111110111101
100000000000000010000000000000000000010000000000000000000C01
101111111111111111111111111111111111111110111111111111110101
100000000000000000000000000000000000000000000000000000000001
111110111111111110111111111111111111111110111111111111111101
1000001000000000000000000000000000000000N0000000000000000001
101111111111111111011111111111111111110111111111111110111101
100000000000000000C10000000000000000000000000000000000000E01
111111111111111111111111111111111111111111111111111111111111