1111111111111
1P000000000E1
1011110111101
100000C000001
1111111111111