111111111111111111111111111111111
1P00000000000000000000000000000E1
11111011111111111C111111111111111
100000100000000000000000000000001
101111111111111111011111111111111
100000000000000000010000000000001
111111011111111111110111111111111
1000000100000N00000000000000000C1
111111111111111111111111111111111