1111111111111
1P000010000E1
1010110111101
100C010001001
1011101010101
10001010000C1
1010101011101
1000000000001
1111111111111