1111111111111
1P000000011E1
1010110110101
10000C0000001
1011111111101
1111111111111