1111111111111
1P000010000E1
1010110111101
100C010000001
1011101110101
10000000000C1
1111111111111