1111111111111
1P100010000E1
1110110111101
100C010000001
1011101110101
10000000000C1
1111111111111