111111111111111111111111111111111111111111111111111111111111
1P0000000N00000000000000000000000100000000000000000000000001
100N00000000000000000000000000000100000000000000000000000001
1000N00000000000N0000N00000000000100000000000000000000000001
100000000000000000000000000000000100000000000000000000000001
100N0N000000000000000000000001111100000010000000000000000001
100000000000000C00000000000000000000000000000000000000000001
100000000N0000N000000000000000000000000000000000000000000001
100000000000000000000000000000000000000000000000000000000001
1000000000000000C000000000000000000000C000000000000000000001
10000000000000000000010000000000000000000000N000000000000001
100000000000000000000011100000000000000000000000000000000001
1000000000000000000001101000000000000C0000000000000000000001
100000000000000000000000100000000000000000000000000000000001
100000000000000000000000100000000000000000000000000000000001
100000000000000000000000100000000000000000000000000000000001
1000000000000000000000001000000000000100000000N0N00000000001
100000000C00000000000000000000000000000000010000000000000001
100000000000000000000000001000000000000000010000000000000001
100000000000000000000000000000000000000000010000000000000001
100000000000000000000000000000000000000000010000000000000001
100000000000000000000000000000000000000000011000000000000001
1000000000000100000N000000000C000000000000001000000000000001
100000000000000000000000000000000000000000001100000000000001
100000000000000000000000000000000000000000000100000000000001
100000000000000000000010000000000000000001111100000000000001
10000000000C000000000010000000000000000111000000001110000001
100000000000000000000010000000100000000001111000001000000001
100000000000000000000010000000000000000000001111111000000001
1000000000000000000000000000000000000000000000000000000000E1
111111111111111111111111111111111111111111111111111111111111