111111111111111111111111111111111111111111111111111111111111
1P0000000000000000000000000000000000C00000000000000000000001
111110111111111110111111111111111111111110111111111111110001
100000100000000000000000000000000000000010000000000000010001
101111111111111111011111111111111111110111111111111110111101
100000000000000000010000000000000000000000000000000000000001
111111011111111111110111111111111111111111111110111111111101
100000010000000000000000000000C00000000000001000000000000001
101111111011111111111111011111111111110111111110111111111101
100000000010000000000000000000000000000000000000000000000001
111111111111110111111110111111111110111111111111111110111101
100000000000000010000000000000000000010000000000000000000001
101111111111111111111111111111111111111110111111111111110101
100000000000000000000000000000000000000000000000000000000001
111110111111111110111111111111111111111110111111111111111101
100000100000000000000000000000000000000010000000000000000C01
101111111111111111011111111111111111110111111111111110111101
100000000000000000010000000000000000C00000000000000000000001
111111011111111111110111111111111111111111111110111111111101
100000010000000000000000000000C00000000000000010000000000001
101111111011111111111111011111111111110111111110111111111101
100000000010000000000000000C00000000000000000000000000000001
111111111111110111111110111111111110111111111111111110111101
100000000000000010000000000000000000010000000000000000000C01
101111111111111111111111111111111111111110111111111111110101
100000000000000000000000000000000000000000000000000000000001
111110111111111110111111111111111111111110111111111111111101
100000100000000000000000000000000000000000000000000000000001
101111111111111111011111111111111111110111111111111110111101
100000000000000000C1000000000000000000000000000000000000NE01
111111111111111111111111111111111111111111111111111111111111